00000000000000000000000000000000000000000000000000000000
00000000000000000000000000000000000000000000000000000000
22200000000000002222222222000000000000000000000000000000
00000000000000000001111111222222000000000000000000000000
00000002222200000000000000000000000000000000000000000222
00000000000000000000000000000000000000000000000000222110
22000000000000000222222222222000000000000000000000011100
11222222222222222111111110000000000000000000000000000000
11111111111111111111111000000000022222222222222222220000
11111111111111111111111000000000000111111111111111000000
11111111111111111111110000000000000000000000000000000000
11111111111111111111000000000000000000000000000000000000
11111111111111111110000000000000000000000000000000000000
